i slept.	நான் தூங்கினேன்.
calm down.	அமைதியாக இருங்கள்
i'll walk.	நான் நடப்பேன்.
who is he?	அவன் யார்?
who knows?	யாருக்குத் தெரியும்?
she smiled.	அவள் சிரித்தாள்
talk to me!	என்னிடம் பேசு
who is she?	அவள் யார்?
go to sleep.	போய் தூங்கு
it may rain.	மழை பெய்யலாம்
she bit him.	அவள் அவனைக் கடித்தாள்
she hit him.	அவள் அவனைக் அடித்தாள்
she is kind.	அவள் அன்பானவள்
she is eight.	அவளுக்கு எட்டு வயது
where are we?	நாம் எங்கே இருக்கிறோம்?
keep in touch!	தொடர்பில் இரு
see you again.	மறுபடியும் சந்திப்போம்
give it to her.	அவளிடம் கொடு
i ate too much.	நான் நிறைய சாப்பிட்டேன்
i'll see to it.	அதை நான் பார்க்கிறேன்
it's up to you.	உன் கையில்தான் இருக்கிறது
leave it to me.	என்னிடம் விட்டுவிடு
listen to this!	இதைக் கேள்
that's the way.	அந்த பக்கம்தான் வழி
come and see me.	என்னை வந்து பார்
don't lie to me.	என்னிடம் பொய் சொல்லாதே
he began to run.	அவன் ஓட ஆரம்பித்தான்
he just arrived.	அவன் இப்பொழுதுதான் வந்தான்
he likes to run.	அவன் ஓட விருப்பப் படுகிறான்
how is your dad?	தங்களுடைய தந்தையார் எப்படி இருக்கிறார்கள்?
i want to sleep.	நான் தூங்க விரும்புகிறேன்
i'm able to run.	என்னால் ஓட முடிகிறது
raise your hand.	கையைத் தூக்கு
what did he say?	அவன் என்ன சொன்னான்?
when can we eat?	எப்பொழுது நம்மால் சாப்பிட முடியும்
come and help us.	வா எங்களுக்கு உதவி செய்
he is still here.	அவன் இன்னும் இருக்கிறான்
i have to go now.	நான் இப்பொழுது போக வேண்டும்
i know that much.	எனக்கு அவ்வளவு தெரியும்.
i made a mistake.	நான் ஒரு தவறு செய்தேன்?
i walk to school.	நான் பள்ளிக்கு நடந்து செல்கிறேன்
that's our house.	அது எங்களுடைய வீடு
those are my cds.	அவைகள் என்னுடைய CD கள்
walk ahead of me.	எனக்கு முன்னால் நட
we'll follow you.	நாங்கள் உன்னைத் பின்பற்றுவோம் (அ) தொடர்வோம்.
beware of the dog!	நாய் ஜாக்கிரதை!
he came back soon.	அவன் சீக்கிரம் திரும்பி வந்தான்
he has three sons.	அவருக்கு மூன்று மகன்கள்
i know how to ski.	எப்படி பனியில் சறுக்கி விளையாடுவது என்பது எனக்கு தெரியும்
i know what to do.	என்ன செய்வது என்பது எனக்குத் தெரியும்
i'm kind of happy.	நான் ஒரு விதமான மகிழ்ச்சியிலிருக்கிறேன்
keep to the right.	வலது பக்கத்தை கடைப் பிடி
she began to sing.	அவள் பாட ஆரம்பித்தாள்
she decided to go.	அவள் போகத் தீர்மானித்தாள்
do i have to study?	நான் படிக்க வேண்டுமா?
he is sure to come.	அவன் வருவது நிச்சயம்
i had to walk home.	நான் வீட்டிற்கு நடக்க வேண்டியிருந்தது
i have to dress up.	நான் ஆடை அணிய வேண்டும்
i told him to come.	நான் அவனை வரச் சொன்னேன்
i'm short of money.	என்னிடம் பணம் குறைவாக இருக்கிறது
may i speak to you?	நான் உன்னிடம் பேசலாமா?
she gave it to him.	அவள் இதை அவனுக்குக் கொடுத்தாள்
she is kind to him.	அவள் அவனிடம் அன்பாக இருக்கிறாள்
she sat next to me.	அவள் எனக்கு அருகில் அமர்ந்தாள்
shut up and listen!	வாயை மூடி கவனி
tell me what to do.	நான் என்ன செய்ய வேண்டும் என்று சொல்
tom runs very fast.	டாம் ரொம்ப வேகமாக ஓடுகிறான்
we ran out of food.	எங்களுக்கு உணவு தட்டுப்பாடு ஏற்பட்டது
we started to walk.	நாங்கள் நடக்க ஆரம்பித்தோம்
when does it begin?	இது எப்பொழுது ஆரம்பிக்கிறது?
are you ready to go?	நீங்கள் போகத் தயாராக இருக்கிறீர்களா?
do you have any gum?	உன்னிடம் ஏதாவது பசை இருக்கிறதா?
does she play piano?	அவள் பியானோ வாசிக்கிறாளோ?
don't listen to her.	அவள் சொல்வதைக் கேட்காதீர்
go and wake mary up.	போய் மேரியை எழுப்பு
he seems to know us.	அவனுக்கு நம்மைப் தெரியும் என்று தோன்றுகிறது
i am engaged to her.	எனக்கு அவளோடு நிச்சயமாகியிருக்கு
i have to leave now.	நான் இப்பொழுது கிளம்ப வேண்டும்
i want to go abroad.	நான் வெளி நாட்டிற்குச் செல்ல விரும்புகிறேன்
i'm glad to see you.	உன்னைப் பார்ப்பதில் நான் மகிழ்ச்சி அடைகிறேன்
i'm proud of my son.	என் மகனைப் பற்றி பெருமைப் படுகிறேன்
i'm taller than you.	நான் உன்னை விட உயரமாக இருக்கிறேன்
i'm trying to sleep.	நான் தூங்குவதற்கு முயற்சி செய்து கொண்டிருக்கிறேன்
it's free of charge.	இதற்கு கட்டணமில்லை
it's time to get up.	தூக்கத்திலிருந்து எழுவதற்கான நேரம் இது
nobody speaks to me.	என் கூட யாரும் பேசுவதில்லை
roll the ball to me.	பந்தை என்னிடம் உருட்டி விடு
she boiled the eggs.	அவள் முட்டைகளை வேக வைத்தாள்
she danced with him.	அவள் அவனோடு நடனம் ஆடினாள்
she gave him a book.	அவள் அவனுக்கு ஒரு புத்தகத்தைக் கொடுத்தாள்
she has 2,000 books.	அவளிடம் 2000 புத்தகங்கள் உள்ளன
this apple is sweet.	இந்த ஆப்பிள் இனிப்பாக இருக்கிறது
we swam in the lake.	அவன் ஏரியில் நீச்சலடித்தான்
come home before six.	ஆறு மணிக்கு முன்பு வீட் டிற்கு வா
go and see who it is.	போய் யார் என்று பார்
i am afraid of bears.	எனக்குக் கரடிகளைக கண்டால் பயம்
i expect him to come.	அவன் வருவான் என எதிர் பார்க்கிறேன்
it's a piece of cake.	இது ஒரு கேக்கின் துண்டு
the boy began to cry.	அந்த பையன் அழ ஆரம்பித்தான்
you keep out of this.	நீ இதில் தலையிடாதே
all of us were silent.	நாங்கள் அனைவரும் அமைதியாக இருந்தோம்
be kind to old people.	வயோதிகர்களிடம் அன்பாக இரு
beware of pickpockets.	ஜேப்படிகாரர்களிடம் ஜாக்கிரதையாக இருக்கவும்
don't drink and drive.	குடித்துவிட்டு வண்டி ஓட்டாதே
he can read and write.	அவனுக்கு எழுதப் படிக்கத் தெரியும்
he got a lot of money.	அவனுக்கு நிறைய பணம் கிடைத்தது
he has a lot of money.	அவனிடம் நிறைய பணமிருக்கிறது
he is afraid of death.	அவனுக்கு இறந்து போவதென்றால் பயம்
he let go of the rope.	அவன் கயிற்றை விட்டான்
i am tired of my work.	நான் வேலை பளுவினால் சோர்வாகயிருக்கிறேன்
i got out of the taxi.	நான் டாக்ஸியிலிருந்து இறங்கினேன்
none of your business.	இது உங்களுக்கு சம்பந்தமில்லாத விஷயம்
they made fun of mary.	அவர்கள் மேரியை கிண்டலடித்தார்கள்
tom and i are friends.	டாமும் நானும் நண்பர்கள்
when is your birthday?	உங்கள் பிறந்த நாள் எப்போது ?
all of them went there.	அவர்கள் எல்லோரும் அங்கே சென்றார்கள்
can you ride a bicycle?	உங்களுக்கு சைக்கிள் ஓட்டத் தெரியுமா?
do you want to be rich?	நீ பணக்காரராக விருப்பமா?
he is afraid of snakes.	அவர்களுக்கு பாம்புகள் என்றால் பயம்
he is fond of swimming.	அவனுக்கு நீச்சல் மீது பற்று உண்டு
he went in place of me.	அவன் எனக்குப் பதிலாக சேன்றான்
he's afraid of the sea.	அவனுக்குக் கடல் என்றால் பயம்
i'll leave that to you.	நான் அதை உன்னிடம் விட்டு விடுகிறேன்
it seems she hates you.	அவள் உன்னை வெறுக்கிற மாதிரி தெரிகிறது
she got engaged to him.	அவள் அவனுக்கு நிச்சயிக்கப் பட்டாள்
she got married to him.	அவள் அவனுக்கு திருமணம் செய்து வைக்கப் பட்டாள்
she stood close to him.	அவனுக்கு நெருக்கமாக நின்றாள்
they're about to leave.	அவர்கள் கிளம்ப இருக்கிறார்கள்
this cd belongs to her.	இந்த சீடி அவளுக்குச் சொந்தமானது
we ran after the thief.	நாங்கள் திருடனுக்குப் பின்னால் ஓடினோம்
what do you plan to do?	நீ என்ன செய்யத் திட்டமிட்டிருக்கிறாய்
a square has four sides.	ஒரு சதுரத்திற்கு நான்கு பக்கங்கள் உள்ளன
charge it to my account.	என்னுடைய கணக்கிற்கு மாற்று
did they write a letter?	அவர்கள் கடிதம் எழுதினார்களா?
he asked us to help him.	எங்களை உதவி செய்யும்படி கேட்டான்
he is known to everyone.	அவன் ஒவ்வொருவருக்கும் அறிமுகமானவன்
he objected to our plan.	எங்களுடைய திட்டத்திற்கு எதிர்ப்புத் தெரிவித்தான்
i just want you to come.	நீ வர வேண்டுமென விரும்புகிறேன்
i want something to eat.	எனக்கு சாப்பிட ஏதாவது வேண்டும்
is he a friend of yours?	அவர் உங்களுடைய நண்பரா?
the news quickly spread.	செய்தி வேகமாக பரவியது
i can't find it anywhere.	இது எங்கே இருக்கு என்று என்னால் கண்டுபிடிக்க முடியவில்லை.
i thought you'd be angry.	நீ கோபமாக இருப்பாய் என்று எண்ணினேன்.
please sit here and wait.	இங்கே அமருங்கள்,தயவு செயது காத்திருங்கள்
she went out of the room.	அவள் அறையை விட்டு வெளியே சென்றாள்
speak slowly and clearly.	மெதுவாகவும் தெளிவாகவும் பேசுங்கள்
the sky is full of stars.	வானம் முழுவதும் நட்சத்திரங்கள் இருக்கின்றன
come and see me right now.	உடனே வந்து என்னைப் பார்க்கவும்
do you have a lot of pens?	உன்னிடம் நிறைய பேனாக்கள் இருக்கின்றனவா?
go and sit by your father.	போய் உன் தந்தையருகில் அமரவும்
he bought a pair of shoes.	நான் ஒரு ஜோடி காலணிகளை வாங்கினேன்
i live on the bottom floor.	நான் கீழ் தளத்தில் வசிக்கிறேன்
i sat between tom and john.	டாமுக்கும் ஜானுக்கும் இடையில் அமர்ந்தேன்
she wore a beautiful dress.	அவள் அழகான ஆடை அணிந்திருந்தாள்
when did you come to japan?	நீ எப்பொழுது ஜப்பான் வந்தாய்?
most people think i'm crazy.	நிறைய மக்கள் நான் பைத்தியம் என்று எண்ணுகிறார்கள்
i suppose tom is still alive.	டாம் இன்னும் உயிருடனிருக்கிறான் என்று எண்ணுகிறேன்.
she asked him for some money.	அவனைக் கொஞ்சம் பணம் கேட்டாள்
tom told me about it himself.	டாம் அதைப் பற்றி அவனே என்னிடம் சொன்னான்.
do you know when he will come?	அவன் எப்ப வருவான் என்று உனக்குத் தெரியுமா
he painted a picture of a dog.	ஒரு நாயின் படத்தை வரைந்தான்
i arrived ahead of the others.	மற்றவர்களுக்கு முன்னே நான் வந்தேன்
i know every inch of the town.	இந்த ஊரின் ஒவ்வொரு அங்குலமும் எனக்குத் தெரியும்
i'm not sharing this with tom.	டாமிடம் நான் இதை பகிர்ந்துகொண்டு இருக்கவில்லை.
she is not afraid of anything.	அவள் எதற்கும் பயப்படுவதில்லை
the price of eggs is going up.	முட்டைகளின் விலை அதிகரித்துக் கொண்டிருக்கிறது
what is the price of this cap?	இந்த தொப்பியின் விலை என்ன?
which of them is your brother?	இவர்களில் யார் உன்னுடைய சகோதரர்
he arrived after the bell rang.	மணி ஒலித்தப் பிறகு அவன் வந்தான்
he was not aware of the danger.	அவன் அபாயத்தை அறிந்திருக்க வில்லை
my throat hurts when i swallow.	சின்ன கேக்குத் துண்டு அவள் தொண்டையில் சிக்கிக் கொண்டது
the school looks like a prison.	இந்த பள்ளி கூடம் ஒரு சிறைச்சாலையைப் போல இருக்கிறது
i'm not sure how to answer this.	எப்படி பதில் சொல்வது என்பதில் நான் உறுதியாக இல்லை.
there's no easy way out of here.	இங்கிருந்து வெளியே செல்ல சுலபமான வழியில்லை.
three vicious dogs attacked tom.	மூன்று மோசமான நாய்கள் டாமை தாக்கின
tom was in australia a year ago.	டாம் ஒரு வருடத்திற்கு முன்னால் ஆஸ்திரேலியாவில் இருந்தார்
when did the wedding take place?	கல்யாணம் எப்பொழுது நடைப் பெற்றது
where do you keep your passport?	நீ பாஸ்போர்ட்டைஎங்கே வைத்திருக்கிறாய்?
because he's sick, he can't come.	அவனுக்கு உடல் நிலை சரியில்லாததனால் அவனால் வர இயலாது
friendship requires mutual trust.	நட்புக்குத் தேவை பரஸ்பர நம்பிக்கை
he put the ring on mary's finger.	அவன் மேரியின் விரலில் மோதிரத்தை அணிவித்தான்
she glanced through the magazine.	அவள் பத்திரிக்கையை மேலோட்டமாகப் பார்த்தாள்
tom has been crying all afternoon.	டாம் மதியம் முழுவதும் அழுதுகொண்டேயிருக்கிறான்.
tom has been in contact with mary.	டாம் மேரியுடன் தொடர்பிலிருந்துருக்கிறான் அல்லது டாம் மேரியுடன் தொடர்பிலிருக்கிறான்.
i want to be a pilot in the future.	நான் எதிர் காலத்தில் ஒரு விமானியாக விரும்புகிறேன்
if tom ran away, where could he go?	டாம் ஓடிவிட்டால், அவரால் எங்கு செல்ல முடியும்?
i had my pocket picked on the train.	இரயிலில் என்னிடம் ஜேப்படி அடிக்கப் பட்டிருந்தது
he told her something and she smiled.	அவன் அவளிடம் ஏதோ சொன்னான் மற்றும் அவள் சிரித்தாள்.
i don't like to go out when it's dark.	இருட்டாக இருக்கும் பொழுது நான் வெளியே போக விரும்புவதில்லை.
when he spoke, everyone became silent.	அவன் பேசியப் பொழுது எல்லோரும் அமைதி காத்தார்கள்
tom drank with us until after midnight.	டாம் நள்ளிரவு வரை எங்களுடன் குடித்தார்.
she has never been in a car driven by him.	அவன் ஒட்டினக் காரில் அவள் எப்பொழுதும் இருந்ததில்லை
tom goes to church with mary every sunday.	டாம் மேரியுடன் ஒவ்வொரு ஞாயிற்றுக் கிழமையும் தேவாலயத்துக்குச் செல்கிறான்.
i don't think people use that word anymore.	மக்கள் அந்த வார்த்தையைப் பயன் படுத்துவதாக எனக்குத் தெரியவில்லை
my younger sister got married in her teens.	என் தங்கை இள வயதிலேய கல்யாணம் செய்து கொண்டாள்
i wonder why tom suggested we do that together.	ஏன் டாம் நாமிருவரும் சேர்ந்து செய்வோமென்று பரிந்துரைத்தான் என்று ஆச்சரியமடைகிறேன்.
tom says he doesn't think he can do that by himself.	என் ஒருவனால் மட்டுமே அதை செய்ய முடியாது என்று நினைக்கிறேன் என டாம் கூறினார்
people who live in glass houses shouldn't throw stones.	கண்ணாடி வீட்டில் வசிப்பவகள் கல்லை எறியக் கூடாது
it's been a long time since i've heard anyone use that word.	ஒருவர் அந்த வார்த்தையைப் பயன் படுத்துவதைக் கேட்டு ரொம்ப நாளாகிறது
if you want your workers to be happy, you need to pay them a decent wage.	உங்களுடைய வேலையாட்கள் மகிழ்ச்சியாக இருக்க வேண்டுமென்றால் நீங்கள் கணிசமான சம்பளம் தர வேண்டும்
it's my fault that the cake was burned. i was talking on the phone and didn't notice the time.	என்னுடையத் தவறினால் கேக்கானதுக் கருகிப் போனது.தோலைப் பேசியில் பேசிக் கொண்டிருந்ததால் நேரத்தைக் கவனிக்க வில்லை
